NO ./assets/textures/NO.xpm
SO ./assets/textures/SO.xpm
WE ./assets/textures/WE.xpm
EA ./assets/textures/EA.xpm

F 220,100,0
C 225,30,0

    111111111111111
1111100011100000001
1110000011100000001
1100000000000000111
11111111111111111